
TEMPS_NIVEAU= 100
TEMPS_MUR= 1
VITESSE_SLIM= 1 
NOMBRE_DIAMANT= 15
LONGUEURX= 38
LONGUEURY= 7

######################################
#B000000002  00000P2  000002  0000000#
#000000000   000000   00000   0000000#
#P00P00P00   0000P0   00PP0   0000P00#
#PP0000P00   000000   00000   0000000#
#0000000P0   00P0P0   0P000   00P000F#
######################################



