
TEMPS_NIVEAU= 80
TEMPS_MUR= 1
VITESSE_SLIM= 1
NOMBRE_DIAMANT= 15
LONGUEURX= 40
LONGUEURY= 11

########################################
#000000000MT00001MMMMMMMMMMMMMMMMMMMMMM#
#B00D00000DM0000MM1000001M1111M00000000#
#00000000000M0MMMM0000000DMM100M011P000#
#00D00000D000MDM100000000000MM10M000000#
#0000D0000000000000D0000000000MM0M00000#
#000000D00000M000000000000000000MM00MMM#
#000000000DMM0D000000000D0000000D0MM00D#
#TT00D0000M0000000000D00000000000000000#
#TT000000MMMMMMMMMMMMMMMMMMMMMMMMMMMM00F
########################################
