
TEMPS_NIVEAU= 120
TEMPS_MUR= 1
VITESSE_SLIM= 1 
NOMBRE_DIAMANT= 36
LONGUEURX= 35
LONGUEURY= 24

###################################
#000000000000000000000000000000M12#
#000000000000000000000000000000M12#
#00B0000TTT00000000000000000000M12#
#0000000TFT00000000000000000000M12#
#0000000TTT00000000000000000000M12#
#000000000000000000000000000000M12#
#000000000000000000000000000000M12#
#000000000000000000000000000000M12#
#000000000000000000000000000000M12#
#000000000000000000000000000000M12#
#000000000000000000000000000000M12#
#000000000000000000000000000000M12#
#000000000000000000000000000000M12#
#000000000000000000000000000000M12#
#000000000000000000000000000000M12#
#000000000000000000000000000000M12#
#00000000000000000000000000000PM12#
#000000000000000000000000000000M12#
#00  00000000000000000000000000M12#
#00 100000000000000000000000000M12#
#000000000000000000000000000000M12#
#000000000000000000000000000000M12#
###################################