
TEMPS_NIVEAU= 180
TEMPS_MUR= 1
VITESSE_SLIM= 5 
NOMBRE_DIAMANT= 85
LONGUEURX= 38
LONGUEURY= 25

######################################
#B000000001  00000P1  000001  0000000#
#00000PP0000PP0000PPP000PP000PPPP0000#
#00P00000000000P0000000P00000P0P00000#
#000000PP0000P0P00P00PP00PP00P0P01P00#
#00P000PP000000001000P00P000PP000PP00#
#000PP0000PP000000P000000P01000P00000#
#000000PP0000P0P00P00PP00PP00PPP00P00#
#0000PPP000P0000000P00000P00000P00000#
#0000000000000P000000P000P00P00000P0 #
#00P000PP0000P0P00000PPP0PP00PPP00P00#
#000000P00P00000P000P0000P000PP000000#
#000PPP000P0000000000000PPP0000000PP0#
#00000000000M000000000M00000000000000#
#00000000000MMMMMMMMMMM000P0000000000#
#000P0000000M000000000M0000000000P000#
#00000P00000M000000000M00000000000000#
#00000000000M000000000M00000000P00000#
#00000000000M000000000M00010000000000#
#0000P000000M000000000M00000000000000#
#00000000000M000000000M00000P01000000#
#00000000000M000000000M0000000000P000#
#00P000P0000M000000000M00000000000000#
#0000P000000MS00000000MF0000000000000#
######################################



