TEMPS_NIVEAU= 150
TEMPS_MUR= 1
VITESSE_SLIM= 12 
NOMBRE_DIAMANT= 30
LONGUEURX= 40
LONGUEURY= 22


########################################
#00B00000000000000000000000000000000000#
#00000000000000000000000000000000000000#
#00000000000000000000000000000000000000#
#00000000000000000000000000000000000000#
#00000000000000000000 010 010 010000000#
#00000000000000000000P0P0P0P0P0P0000000#
#00000000000000000000000000000000000000#
#00000000000000000000000000000000000000#
#00000000010 0 0 0 0 000000000000000000#
#000000000 0 0 0 0 0 000000000000000000#
#000000000 010 0 0 0 000000000000000000#
#000000000 0 0 0 0 0 000000000000000000#
#000000000 0 010 0 0 000000000000000000#
#000000000 0 0 0 0 0 000000000000000000#
#000000000 0 0 010 0 000000000000000000#
#000000000 0 0 0 0 0 000000000000000000#
#000000000 0 0 0 010 000000000000000000#
#000000000 0 0 0 0 0 000000000000000000#
#000000000 0 0 0 0 01000000000000000000#
#00000000000000000000000000000000000000#
########################################

