
TEMPS_NIVEAU= 150
TEMPS_MUR= 1
VITESSE_SLIM= 1
NOMBRE_DIAMANT= 8
LONGUEURX= 40
LONGUEURY= 23

########################################
#00000000000000000000000000000000000000#
#B0000000000000000000000000000000000000#
#00000000000000000000000000000000000000#
#00000000000000000000000000000000000000#
#00000000000000000000000000000000000000#
#00000000000000000000000000000000000000#
#00000000000000000000000000000000000000#
#00000001  000001  000001  000001  0000#
#0000000   00000   00000   00000   0000#
#0000000 D 00000 D 00000 D 00000 D 0000#
#00000000000000000000000000000000000000#
#00000000000000000000000000000000000000#
#00000000000000000000000000000000000000#
#00000001  000001  000001  000001  0000#
#0000000   00000   00000   00000   0000#
#0000000 D 00000 D 00000 D 00000 D 0000#
#00000000000000000000000000000000000000#
#00000000000000000000000000000000000000#
#00000000000000000000000000000000000000#
#00000000000000000000000000000000000000#
#00000000000000000000000000000000000000F
########################################

