
TEMPS_NIVEAU= 200
TEMPS_MUR= 1
VITESSE_SLIM= 1 
NOMBRE_DIAMANT= 45
LONGUEURX= 37
LONGUEURY= 18

#####################################
#FB000P00P000000P0000P000P0000000PP0#
#00000P000000P0P00000P000000P0P0000P#
#0P00PP0000P000000P000000P0000000000#
#000P00P0000000000000000000P00000000#
#00000000 200000PP000 2000P0 200000P#
#0P0P0000  00P00P0000  000P0  00000P#
#P00P000P00PP00000000PP00000000P0000#
#P0P00P0000000PP000P0000P00P0P000000#
#000P000000000P00000000000000000P000#
#0000P000 20000P00000 200PP0 200000P#
#0P000000  00P00P0000  000P0  00000P#
#0P00PP0000P000000P000000P0000000000#
#000P000000000P00000000000000000P000#
#00000P00P000000P0000P000P0000000PP0#
#00000000000000000000000000000000000#
#00000000000000000000000000000000000#
#####################################
