TEMPS_NIVEAU= 150
TEMPS_MUR= 1
VITESSE_SLIM= 1 
NOMBRE_DIAMANT= 4
LONGUEURX= 40
LONGUEURY= 22


########################################
#MMMMMMMMM0000P0P00P00000000P0MMMMMMMMM#
#M        00000000000P0000P000        M#
#M D     100P0000000000P000P001     D M#
#MMMMMMMMM00P00000000P000000P0MMMMMMMMM#
#M        000000P000P0000000P0        M#
#M D     10000P000000P0PP000001     D M#
#MMMMMMMMM0PP00000000P0PP00000MMMMMMMMM#
#M        0000P0P0000P00P00000        M#
#M D     10000P0P0000P00P00P001     D M#
#MMMMMMMMM0PP0P00P0000P000P000MMMMMMMMM#
#M        0PP0P00P000000000000        M#
#M D     10000P00P00000000P0001     D M#
#MMMMMMMMM00000P000P0000P00P00MMMMMMMMM#
#0000P0P00P00000000P00000P000000000000P#
#000000P0000P0000P00P0P000P00P000000000#
#00P0000P00000P000P0000000P00P000000000#
#00P00000000P000000P0PP000000000P000000#
#P0B000P00000000000P0PP000000000PP00P0F#
#0000P000000P0PP000000P00000000P00P0000#
#PP000000000P0PP000000000P00P0P0P00P000#
########################################
