TEMPS_NIVEAU= 160
TEMPS_MUR= 1
VITESSE_SLIM= 12 
NOMBRE_DIAMANT= 50
LONGUEURX= 40
LONGUEURY= 22

########################################
#P00000PP0F00000P0BPS0000000P00000000P0#
#00000P0P00000000000P0000P00P0P00000000#
#00000000P00P0000000000000P000000000000#
#P0000000P0000000000P000000P00P00000000#
#P00000000P00000P00P0000000P00P00000000#
#0P00P00000000P000000P0PP000000000P0000#
#00P00000P00000000000P0PP000000000P000P#
#000000P000000P0P0000P00P00000000P00P00#
#P0P0000000000P0P0000000000P00000000000#
#0000000000PP0P00P0000P000P0000P00P0P00#
#0000000000P00P00P00000000000P00000P000#
#000P0P0000000P00000000000P00000000P000#
#000P0P000P0000P000P0000000P00000000000#
#0000P0P00P00000000P0000P0000000000000P#
#000000P0000P0000P00P0P000000P000000000#
#00P0MMMMMMMMMMMMMMMMMMMMMMMMMMMMMM0000#
#00P01111111111111111111111111111110000#
#P000PPPPPPPPPPPPPPPPPPPPPPPPPPPPPP0P00#
#00000000000000000000000000000000000000#
#0P00000000000000000000000000000000P000#
########################################
