TEMPS_NIVEAU= 150
TEMPS_MUR= 50
VITESSE_SLIM= 1 
NOMBRE_DIAMANT= 12
LONGUEURX= 40
LONGUEURY= 22


########################################
#B00P0000000000P00000000P00000P00P00000#
#0P0PP000000000P000P00000000P000000P0P0#
#0P00P00000000P00P0000P0P0000000000P0PP#
#0000000P00P00000P00000000000000PP0P00P#
#00P000P0000P00P0P00000000000000P00P00P#
#000000000P00000P00000000PPP0000000P000#
#0000P0000P00000P00000000P0PP00P0000P00#
#00P000M----M00M----M00000P0P00P0000000#
#00000PM0000M00M00PPM0000000P0000P0000P#
#P0P000M00P0M00M0000M000P0000P00000P000#
#000000M00P0M00M0000MP00P00000000P00000#
#0PP000M0000MP0M0000M0P00000P0000000P00#
#0PP000M0000MPPM0P00M00000P000000P0PP00#
#00P000M0000M00M0000M0PP000000000P0PP00#
#00000PMMMMMM00MMMMMM000000000000P00P00#
#P000P0000P00P0P00000000000000000P00P00#
#0000000000000P00000000P00000P00000000P#
#00P00P00 1000000 10000P0 100P000 1000P#
#P00000P0  000000  000000  00P000  000P#
#000000P000000000000000000000000P000P00#
########################################