
TEMPS_NIVEAU= 150
TEMPS_MUR= 1
VITESSE_SLIM= 1 
NOMBRE_DIAMANT= 24
LONGUEURX= 40
LONGUEURY= 22

########################################
#P0MM0MPP0M000PMP00P0000M000P00000PM0D0#
#00BM0D0P0M000MMM00M0P0000P00P0P000M0MP#
#0000M00PD00P0000M00000P0MMP0000000M0MM#
#D0M00MPMP00P0000M000P000000P0PP000000M#
#P0M000M00P0MM00P0MMD0000000P0PP000000M#
#PP00P0000M000P000000P0PP000000P00DMM00#
#00P0MM00P0PP000M0000P0PP000000M00P0M0P#
#00M000D000000D0P00MMP00P0M0MP00MP00D0P#
#P0P0000M0MM00D0P00MMP00P00D0M000M00P0M#
#0P0MM00000PPMPMMD0M0MP00MP000MP00D0P00#
#M0MM000000PPMPMMP0M0MM000M00P0MM00P0MM#
#0M0P0P0M000MMP00P0000M000P00000MM0P0MM#
#0M0P0P0M0D0M0MP00MP0000P00P0PP0000M000#
#M00MPMP00P0000M000D000M0PM000000M0MM0D#
#M000MMP00M0D000MP00P0P000P0MP000000M00#
#M0D0000P0MM00P0MMP0000000P0MP000000M00#
#00P0000M000P000000P0PP000000M00P0M000M#
#P0MM00P0MM000M0000P0PP000000M00PD00P00F
#M000P000000P0PD000000P000MM00MP00D0M00#
#PP000M00000P0PD000000M00P0MD0D0PM0P000#
########################################

