TEMPS_NIVEAU= 150
TEMPS_MUR= 1
VITESSE_SLIM= 1 
NOMBRE_DIAMANT= 75
LONGUEURX= 40
LONGUEURY= 22

########################################
#DDDPPDDPDDP0PPPPDPDD0DDPDDPDDDDPPDPDPP#
#DPPDDDPPPDPDDPPPPPPDPPD0DPDPPPPDPDDPPD#
#DDPPPPPPPDPDDPP0PPPDPPDDDPDP0PPDPPPDDP#
#PPDPDDPPPPPPDPPDDD00DDPPDPDDPPDPDD0PPD#
#PPDPDDPPPPPPDPPD0DPDPPPPDPDPDPPDDPPDPD#
#DDDPPDPD0DDPPDDPPDDDPPDPDPPP0DPDDPPDPD#
#PPPPPDPPDDDD00PPPDPDD0PDPDDP0PPDDDDDDP#
#DPDDMMMMMMM0MMMMMDPPPPDPMMMMMM0MMMMMMP#
#D0DDM           MPDDPPPDM           MP#
#DPDPM BF        MPDDPPPDM           MP#
#DPPDM           MP0PPDDPM           MP#
#DPPDM           MDDDDPDPM           MD#
#PDDDM           MDPPD0DPM           MD#
#PPPPM           MDPPDDPPM           MP#
#DPDDM           M0PDPPDPM           MP#
#DPDDM           MMMMMMMMM           MP#
#PPPDM                               MP#
#PPPDM           MDD0P0P0M           MP#
#DDPPM           MPPPDPDDM           MP#
#DD00MMMMMMMMMMMMMDPPPDDDMMMMMMMMMMMMMD#
########################################
