###################################
#000000000000000000000000000000M12#
#000000000000000000000000000000M12#
#00B0000SSS00000000000000000000M12#
#0000000SFS00000000000000000000M12#
#0000000SSS00000000000000000000M12#
#000000000000000000000000000000M12#
#000000000000000000000000000000M12#
#000000000000000000000000000000M12#
#000000000000000000000000000000M12#
#000000000000000000000000000000M12#
#000000000000000000000000000000M12#
#000000000000000000000000000000M12#
#000000000000000000000000000000M12#
#000000000000000000000000000000M12#
#000000000000000000000000000000M12#
#000000000000000000000000000000M12#
#00000000000000000000000000000PM12#
#000000000000000000000000000000M12#
#00  00000000000000000000000000M12#
#00 100000000000000000000000000M12#
#000000000000000000000000000000M12#
#000000000000000000000000000000M12#
###################################
X