TEMPS_NIVEAU= 30
TEMPS_MUR= 1
VITESSE_SLIM= 1 
NOMBRE_DIAMANT= 16
LONGUEURX= 20
LONGUEURY= 12

####################
#P1000000000000000P#
#BP10000000000000PF#
#D0P100000000000P0D#
#PD0P1000000000P0DP#
#0PD0P10000000P0DP0#
#00PD0P100000P0DP00#
#000PD0P1000P0DP000#
#0000PD0P10P0DP0000#
#00000PD0PP0DP00000#
#000000PD00DP000000#
####################
