31 146
0 0 0 0 0 0 0 0 0 0 0 0 0 0 0 0 0 0 0 0 0 0 0 0 0 0 0 0 0 0 0 
0 0 0 0 0 0 0 0 0 0 0 0 0 0 0 0 0 0 0 0 0 0 0 0 0 0 0 0 0 0 0 
0 0 0 0 0 0 0 0 0 0 0 0 0 0 0 0 0 0 0 0 0 0 0 185 186 0 0 0 0 0 0 
1 1 1 1 1 1 1 1 1 1 1 1 1 1 6 7 1 1 1 1 1 1 1 187 188 1 1 1 1 1 1 
10 2 2 2 2 2 2 2 2 2 2 2 2 2 5 8 2 2 2 2 2 2 2 2 2 2 2 2 2 2 11 
33 116 116 116 116 116 116 116 116 116 116 116 116 116 116 116 116 116 116 116 116 116 116 116 116 116 116 116 116 116 34 
3 0 0 0 0 0 0 0 0 0 0 0 0 0 0 0 0 0 0 0 0 0 0 0 0 0 0 0 0 0 4 
33 116 116 116 116 116 116 116 116 116 116 116 116 116 116 116 116 116 116 116 116 116 116 116 116 116 116 116 116 116 34 
3 0 0 0 0 0 0 0 0 0 0 0 0 0 0 0 0 0 0 0 0 0 0 0 0 0 0 0 0 0 4 
9 1 1 1 1 1 1 155 73 1 1 1 1 1 1 1 1 1 1 28 1 6 7 1 28 1 155 1 1 1 12 
10 2 2 2 2 2 2 2 2 2 2 2 2 2 2 2 2 2 2 11 10 5 8 11 10 2 2 2 2 2 11 
3 0 0 0 0 0 0 0 0 0 0 0 0 0 0 0 0 0 0 176 39 77 151 40 175 0 0 0 0 0 4 
175 0 0 0 0 0 0 0 0 0 0 0 0 0 0 0 0 0 0 0 0 0 0 0 0 0 0 0 0 0 176 
3 0 0 0 0 0 0 0 0 0 0 0 0 0 0 0 0 0 0 0 0 0 0 0 0 0 0 0 0 0 4 
3 0 0 0 0 0 0 0 0 0 0 0 0 0 0 0 0 0 0 0 0 0 0 0 0 0 0 0 0 0 4 
3 0 0 0 0 0 0 0 0 0 0 0 0 0 0 0 0 0 0 0 0 0 0 0 0 0 0 0 0 0 4 
3 0 0 0 0 0 0 0 0 0 0 0 0 0 0 0 0 0 0 0 0 0 0 0 0 0 0 0 0 0 4 
175 0 0 0 0 0 0 0 0 0 0 0 0 0 0 0 0 0 0 0 0 0 0 0 0 0 0 0 0 0 176 
3 0 0 0 0 0 0 0 0 0 0 0 0 0 0 0 0 0 0 0 0 0 0 0 0 0 0 0 0 0 4 
3 0 0 0 0 0 0 0 0 0 0 0 0 0 0 0 0 0 0 0 0 0 0 0 0 0 0 0 0 0 4 
3 0 0 0 0 0 0 0 0 0 0 0 0 0 0 0 0 0 0 0 0 0 0 0 0 0 0 0 0 0 4 
3 0 0 0 0 0 0 0 0 0 0 0 0 0 0 0 0 0 0 0 0 0 0 0 0 0 0 0 0 0 4 
3 0 0 0 0 0 0 0 0 0 0 0 0 0 0 0 0 0 0 0 0 0 0 0 0 0 0 0 0 0 4 
175 0 0 0 0 0 0 0 0 0 0 0 0 0 0 0 0 0 0 0 0 0 0 0 0 0 0 0 0 0 176 
3 0 0 0 0 0 0 0 0 0 0 0 0 0 0 0 0 0 0 0 0 0 0 0 0 0 0 0 0 0 4 
3 0 0 0 0 0 0 0 0 0 0 0 0 0 0 0 0 0 0 0 0 0 0 0 0 0 0 0 0 0 4 
9 1 1 1 1 1 1 1 1 1 1 1 1 1 1 1 1 1 1 1 1 1 1 1 1 1 6 0 0 7 12 
18 17 17 17 17 17 20 18 17 17 17 17 17 17 18 17 17 17 17 20 17 17 17 17 17 17 33 116 116 34 18 
10 2 2 2 2 2 2 2 2 2 2 2 2 2 2 2 2 2 2 2 2 2 2 2 2 2 5 0 0 8 11 
3 0 0 0 0 0 0 0 0 0 0 0 0 0 0 0 0 0 0 0 0 0 0 0 0 0 0 0 0 0 4 
3 0 0 0 0 0 0 0 0 0 0 0 0 0 0 0 0 0 0 0 0 0 0 0 0 0 0 0 0 0 4 
175 0 0 0 0 0 0 0 0 0 0 0 0 0 0 0 0 0 0 0 0 0 0 0 0 0 0 0 0 0 176 
3 0 0 0 0 0 0 0 0 0 0 15 14 0 0 0 0 0 0 0 0 0 0 0 0 0 0 0 0 0 4 
9 1 1 1 6 0 7 1 1 1 16 17 18 13 1 1 1 1 1 1 1 1 1 1 1 1 1 1 1 1 12 
10 2 2 2 5 0 8 2 2 2 2 2 2 2 2 2 2 2 2 2 2 2 2 2 2 2 2 2 2 2 11 
3 0 0 0 0 0 0 0 0 0 0 0 0 0 0 0 0 0 0 0 0 0 0 0 0 0 0 0 0 0 4 
3 0 0 0 0 0 0 0 0 0 0 0 0 0 0 0 0 0 0 0 0 0 0 0 0 0 0 0 0 0 4 
175 0 0 0 0 0 0 0 0 0 0 0 0 0 0 0 0 0 0 0 0 0 0 0 0 0 0 0 0 0 176 
3 0 0 0 0 0 0 0 0 0 0 0 0 0 0 0 0 0 0 0 0 0 0 0 0 0 0 0 0 0 4 
3 0 0 0 0 0 0 0 0 0 0 0 47 155 155 46 0 0 0 0 0 0 0 0 0 0 0 0 0 0 4 
33 116 116 116 116 116 116 116 116 116 116 116 34 75 76 33 116 116 116 116 116 116 116 116 116 116 116 116 116 116 34 
33 116 116 116 116 116 116 116 116 116 116 116 34 74 76 33 116 116 116 116 116 116 116 116 116 116 116 116 116 116 34 
3 0 0 0 0 0 0 0 0 0 0 0 48 156 156 45 0 0 0 0 0 0 0 0 0 0 0 0 0 0 4 
3 0 47 197 197 46 0 0 0 0 0 0 0 0 0 0 0 0 0 0 0 0 0 0 0 0 0 0 0 0 4 
3 0 44 57 57 199 0 0 0 0 0 0 0 0 0 0 0 0 0 0 0 0 0 0 0 0 0 0 0 0 4 
3 0 48 42 42 45 0 0 0 0 0 0 0 0 0 0 0 0 0 0 0 0 0 0 0 0 0 0 0 0 4 
199 0 0 0 0 0 0 0 0 0 0 0 0 0 0 0 0 0 0 0 0 107 171 171 171 106 0 0 0 0 4 
199 0 0 0 0 0 0 0 0 0 0 0 0 0 0 0 0 0 0 0 0 180 127 127 127 179 0 0 0 0 4 
199 0 0 0 0 0 0 0 0 0 0 0 0 0 0 0 0 0 0 0 0 180 127 127 127 179 0 0 0 0 4 
3 0 0 0 0 0 0 0 0 0 0 0 47 155 41 46 0 0 0 0 0 180 127 127 127 179 0 0 0 0 4 
3 0 0 0 0 0 0 0 0 0 0 0 176 57 57 175 0 0 0 0 0 108 172 172 172 105 0 0 0 0 4 
3 0 0 0 0 0 0 0 0 0 0 0 176 57 57 175 0 0 0 0 0 0 0 0 0 0 0 0 0 0 4 
3 0 0 0 0 0 0 0 0 0 0 0 48 156 156 45 0 0 0 0 0 0 0 0 0 0 0 0 0 0 4 
3 0 0 0 0 0 0 0 0 0 0 0 0 0 0 0 0 0 0 0 0 0 0 0 0 0 0 0 0 0 4 
203 47 41 41 41 46 0 0 0 0 0 0 0 0 0 0 0 0 0 0 0 0 0 0 0 0 0 0 0 0 4 
3 44 65 57 67 199 0 0 0 0 0 0 0 0 0 0 0 0 47 197 197 41 41 197 197 41 41 197 197 46 0 
3 48 198 198 198 45 0 0 0 0 0 0 0 0 0 0 0 0 176 64 64 64 64 64 64 64 64 64 64 215 236 
3 0 0 0 0 0 0 0 0 0 0 0 0 0 0 0 0 0 48 42 42 42 42 42 42 42 42 214 42 45 0 
3 0 0 0 0 0 0 0 0 0 0 0 0 0 0 0 0 0 0 0 0 0 0 0 0 0 0 92 0 0 4 
3 0 0 0 0 0 0 0 0 0 0 0 0 0 0 0 0 0 0 0 0 0 0 0 0 0 0 92 0 0 4 
3 0 0 0 0 0 0 0 0 0 0 0 0 0 0 0 0 0 0 0 0 0 0 0 0 0 0 92 0 0 4 
3 0 0 0 0 0 0 0 0 0 0 0 0 0 0 0 0 0 0 0 0 0 0 0 0 0 0 92 0 0 4 
3 0 0 0 0 0 0 0 0 0 0 0 0 0 0 0 0 0 0 0 0 0 0 0 0 0 0 81 0 0 4 
3 0 0 0 0 0 0 0 0 0 0 0 0 0 0 0 0 0 0 0 0 0 0 0 0 0 0 81 0 0 4 
3 0 0 0 0 0 0 0 0 0 0 0 0 0 0 0 0 0 0 0 0 0 0 0 0 0 0 81 0 0 4 
3 0 0 0 0 0 0 0 0 0 0 0 0 0 0 0 0 0 0 0 0 133 134 0 0 0 0 81 0 0 4 
175 0 0 0 0 0 0 0 0 0 0 0 0 0 0 0 0 0 0 0 0 135 136 0 0 0 0 81 0 0 4 
175 0 0 0 0 0 0 0 0 0 0 0 0 0 0 0 0 0 0 0 0 47 213 46 133 134 0 81 0 0 4 
175 0 0 0 0 0 0 0 0 0 0 0 0 0 0 0 0 0 0 133 134 216 63 215 135 136 0 87 85 0 4 
175 0 0 0 0 0 0 0 0 0 0 0 0 0 0 0 0 0 0 135 136 48 214 45 0 0 0 0 81 0 4 
175 0 0 0 0 0 0 0 0 0 0 0 0 0 0 0 0 0 0 0 0 0 133 134 0 0 0 0 92 0 4 
3 0 0 0 0 0 0 0 0 0 0 0 0 0 0 0 0 0 0 0 0 0 135 136 0 0 0 0 92 0 4 
3 0 0 0 0 0 0 0 0 0 0 0 0 0 0 0 0 0 0 0 0 0 0 0 0 0 0 0 81 0 4 
3 0 0 0 0 0 0 0 0 0 0 0 0 0 0 0 0 0 0 0 0 0 0 0 0 0 0 0 81 0 4 
239 0 0 0 0 0 0 0 0 0 0 0 0 0 0 0 0 0 0 0 0 0 0 0 0 0 0 0 81 0 4 
239 0 0 0 0 0 0 0 0 0 0 0 0 0 0 0 0 0 0 0 0 0 0 0 0 0 0 0 81 0 4 
239 0 0 0 86 82 116 116 116 116 82 82 82 82 82 82 82 93 95 82 82 82 82 82 82 82 82 82 84 0 4 
239 0 0 0 81 0 0 0 0 0 0 0 0 0 0 0 0 0 0 0 0 0 0 0 0 0 0 0 0 0 4 
3 0 0 0 81 0 0 0 0 0 0 0 0 0 0 0 0 0 0 0 0 0 0 0 0 0 0 0 0 0 4 
3 0 0 0 81 0 0 0 0 0 0 0 0 0 0 0 0 0 0 0 0 0 0 0 0 0 0 0 0 0 4 
3 0 0 0 81 0 0 0 0 0 0 0 0 0 0 0 0 0 0 0 0 0 0 0 0 0 0 0 0 0 4 
3 0 0 0 81 0 0 0 0 0 0 0 0 0 0 0 0 0 0 0 0 0 0 0 0 0 0 0 0 0 4 
3 0 0 0 81 0 0 0 0 0 0 0 0 0 0 0 0 0 0 0 0 0 0 0 0 0 0 0 0 0 4 
3 0 0 0 81 0 0 0 0 0 0 0 0 0 0 0 0 0 0 0 0 0 0 0 0 0 0 0 0 0 4 
3 0 0 0 81 0 0 0 0 0 0 0 0 0 0 0 0 0 0 0 0 0 0 0 0 0 0 0 0 0 4 
3 0 0 0 81 0 0 0 0 0 0 0 0 0 0 0 0 0 0 0 0 0 0 0 0 0 0 0 0 0 4 
235 82 82 82 84 0 0 0 0 0 0 0 0 0 0 0 0 0 0 0 0 0 0 0 0 0 0 0 0 0 4 
239 0 0 0 0 0 0 0 0 0 0 0 0 0 0 0 0 0 0 0 0 0 0 0 0 0 0 0 0 0 4 
239 0 0 0 0 0 0 0 0 0 0 0 0 0 0 0 0 0 0 0 0 0 0 0 0 0 0 0 0 0 4 
239 0 0 0 0 0 0 0 0 0 0 0 0 0 0 0 0 0 0 0 0 0 0 0 0 0 0 0 0 0 4 
239 0 0 0 0 0 0 0 0 0 0 0 0 0 0 0 0 0 0 0 0 0 0 0 0 0 0 0 0 0 4 
239 0 0 0 0 0 0 0 0 0 0 0 0 0 0 0 0 0 0 0 0 0 0 0 0 0 0 0 0 0 4 
3 0 0 0 0 0 0 0 0 0 0 0 0 0 0 0 0 0 0 0 0 0 0 0 0 0 0 0 0 0 4 
3 0 0 0 0 0 0 0 0 0 0 0 0 0 0 0 0 0 0 0 0 0 0 0 0 0 0 0 0 0 4 
3 0 0 0 0 0 0 47 155 46 0 0 0 0 0 0 0 0 0 0 0 0 0 0 0 0 0 0 0 0 4 
3 0 0 0 0 0 0 176 63 175 0 0 0 0 0 0 0 0 0 47 155 155 46 0 0 0 0 0 0 0 4 
3 0 0 0 0 0 0 48 156 45 0 0 0 0 0 0 0 0 0 176 57 57 175 0 0 0 0 0 0 0 4 
239 0 0 0 0 0 0 0 0 0 0 0 0 0 0 0 0 0 0 176 57 57 175 0 0 0 0 0 0 0 4 
239 0 0 0 0 0 0 0 0 0 0 0 0 0 0 0 0 0 0 48 156 156 45 0 0 0 0 0 0 0 4 
239 0 0 0 0 0 0 0 0 0 0 0 0 0 0 0 0 0 0 0 0 0 0 0 0 0 0 0 0 0 4 
239 0 0 0 0 0 0 0 0 0 0 0 0 0 0 0 0 0 0 0 0 0 0 0 0 0 0 0 0 0 4 
3 0 0 0 0 0 0 0 0 0 0 0 0 0 0 0 0 0 0 0 0 0 0 0 0 0 0 0 0 0 4 
3 0 0 0 0 0 0 0 0 0 0 0 0 0 0 0 0 0 0 0 0 0 0 0 0 0 0 0 0 0 4 
239 0 0 0 0 0 0 0 0 0 0 0 0 0 0 0 0 0 0 0 0 0 0 0 0 0 0 0 0 0 4 
239 0 0 0 0 0 0 0 0 0 0 0 0 0 0 0 0 0 0 0 0 0 0 0 0 0 0 0 0 0 4 
239 0 0 0 0 0 0 0 0 0 0 0 0 0 0 0 0 0 0 0 0 0 0 0 0 0 0 0 0 0 4 
239 0 0 0 0 0 0 0 0 0 0 0 0 0 0 0 0 0 0 0 0 0 0 0 0 0 0 0 0 0 4 
239 0 0 0 0 0 0 0 0 0 0 0 0 0 0 0 0 0 0 0 0 0 0 0 0 0 0 0 0 0 4 
3 0 0 0 0 0 0 0 0 0 0 0 0 0 0 0 0 0 0 0 0 0 0 0 0 0 0 0 0 0 4 
3 0 0 0 0 0 0 0 0 0 0 0 0 99 93 98 0 0 0 0 0 0 0 0 0 0 0 0 0 0 4 
175 0 0 0 0 0 0 0 0 0 189 207 208 193 143 92 0 0 0 0 0 0 0 0 0 0 0 0 0 0 176 
175 0 0 0 0 0 0 0 0 0 108 194 194 194 105 81 0 0 0 0 0 0 0 0 0 0 0 0 0 0 176 
175 0 0 0 0 0 0 0 0 0 99 91 91 91 82 84 0 0 0 0 0 0 0 0 0 0 0 0 0 0 176 
3 0 0 0 0 0 0 0 0 0 94 0 0 0 0 0 0 0 0 0 0 0 0 0 0 0 0 0 0 0 4 
235 82 82 82 82 82 82 82 82 89 91 116 82 83 82 82 82 82 82 82 82 82 82 82 82 82 82 0 0 93 216 
203 0 0 0 0 30 0 0 0 81 0 0 0 81 86 82 82 82 82 116 82 82 82 82 82 82 82 82 82 82 236 
203 0 0 0 0 81 0 0 0 81 0 82 82 83 83 82 82 82 82 82 82 82 82 82 82 82 82 82 82 0 4 
203 0 0 0 0 81 0 0 0 81 0 0 0 81 81 86 82 82 82 82 116 82 82 82 82 82 82 82 82 82 236 
203 0 0 0 0 81 0 0 0 81 0 0 0 81 81 81 44 199 0 0 0 0 0 0 0 0 0 0 0 0 200 
175 0 0 0 0 81 0 0 86 84 0 0 0 81 81 81 44 199 0 0 0 0 0 0 0 0 0 0 0 0 200 
175 0 0 0 0 94 0 86 84 0 0 0 0 81 81 81 44 199 0 0 0 0 0 0 0 0 0 0 0 0 200 
175 7 6 0 0 100 93 97 0 86 82 82 82 83 91 91 82 82 82 82 82 82 82 82 82 82 82 82 82 82 236 
215 236 203 0 0 0 0 0 0 81 0 0 86 84 0 0 0 0 0 0 0 0 0 0 0 0 0 0 0 0 4 
215 236 203 0 0 0 0 0 0 81 0 99 97 0 0 0 0 0 0 0 0 0 0 0 0 0 0 0 0 0 4 
175 8 5 0 0 86 82 82 82 91 82 97 0 0 0 86 82 82 82 82 82 82 82 82 82 82 82 82 82 0 216 
175 0 0 0 0 81 0 0 0 0 0 0 99 82 82 84 0 0 0 0 0 0 0 0 0 0 0 0 0 0 216 
175 0 0 0 0 81 0 0 0 0 0 0 81 0 0 0 86 82 82 82 82 82 82 82 82 82 82 82 82 82 216 
203 0 0 0 0 81 0 0 0 0 0 0 81 0 0 0 81 0 0 0 0 0 0 0 0 0 0 0 0 0 4 
203 0 0 0 0 0 0 0 0 0 0 0 81 0 0 0 81 0 0 0 0 0 0 0 0 0 0 83 85 0 4 
235 98 0 0 0 0 0 0 0 0 0 0 81 0 0 99 84 86 82 82 89 89 93 82 82 82 93 88 90 93 236 
3 100 95 96 98 0 0 0 0 0 0 0 81 0 0 100 98 81 0 0 92 92 0 0 0 0 0 90 84 0 4 
3 0 0 0 87 82 132 132 82 82 93 95 84 0 0 0 100 83 93 95 83 91 93 82 82 82 82 84 0 0 4 
3 0 0 0 0 0 0 0 0 0 0 0 0 0 0 0 0 87 82 82 84 0 0 0 0 0 0 0 0 0 4 
199 0 0 0 0 0 0 0 0 0 0 0 0 0 0 0 0 0 0 0 0 0 0 0 0 0 0 0 0 0 200 
199 0 0 0 0 0 0 0 0 0 0 0 0 0 0 0 0 0 0 0 0 0 0 0 0 0 0 0 0 0 200 
199 0 0 0 0 0 0 0 0 0 0 0 0 0 0 0 0 0 0 0 0 0 0 0 0 0 0 0 0 0 200 
43 0 0 0 0 0 0 55 41 54 0 0 0 0 0 0 0 0 0 0 0 0 0 0 0 0 0 0 0 0 44 
49 41 41 41 155 41 56 57 57 57 53 41 41 41 155 155 41 46 0 0 47 155 155 41 41 41 41 41 41 41 52 
57 57 57 57 57 57 57 57 57 57 57 57 57 50 42 42 42 45 0 0 48 42 42 42 42 42 42 42 42 42 51 
50 42 42 42 42 42 42 42 42 42 42 42 42 45 0 0 0 0 0 0 0 0 0 0 0 0 0 0 0 0 44 
43 0 0 0 0 0 0 0 0 0 0 0 0 0 0 0 0 0 0 0 0 0 0 0 0 0 0 0 0 0 44 
43 0 0 0 0 0 0 0 0 0 0 0 0 0 0 0 0 0 0 0 0 0 0 0 0 0 0 0 0 0 44 
199 0 0 0 0 0 0 0 0 0 0 0 0 0 0 0 0 0 0 0 0 0 0 0 0 0 0 0 0 0 200 
199 0 0 0 0 0 0 0 0 0 0 0 0 0 0 0 0 0 0 0 0 0 0 0 0 0 0 0 0 0 200 
43 0 0 0 0 0 0 0 0 223 0 0 0 0 0 111 0 0 0 30 0 0 209 210 0 0 0 0 0 0 44 
61 41 41 41 41 41 41 41 41 224 155 41 41 41 41 213 41 41 41 213 155 41 229 230 41 41 41 41 41 41 62 
2
1 153 0
29 153 0
0
