21 92
0 0 0 0 0 0 0 0 0 0 0 0 0 0 0 0 0 0 0 0 0 
0 0 0 0 0 0 0 0 0 0 0 0 0 0 0 0 0 0 0 0 0 
0 0 0 0 0 0 0 0 0 0 0 0 0 0 0 0 0 0 0 0 0 
0 0 0 0 0 0 0 0 0 0 0 0 0 0 0 0 0 0 0 0 0 
0 0 0 0 0 0 0 0 0 0 0 0 0 0 0 0 0 0 0 0 0 
0 0 0 0 0 0 0 0 0 0 0 0 0 0 0 0 0 0 0 0 0 
0 0 0 0 0 0 0 0 0 0 0 0 0 0 0 0 0 0 0 0 0 
1 1 1 1 1 1 1 1 28 6 0 7 28 1 1 1 1 1 1 1 1 
10 238 238 2 38 2 11 17 10 5 7 12 18 17 18 17 17 17 17 17 17 
3 0 0 0 131 0 4 17 39 77 40 17 17 17 17 17 18 17 17 17 17 
3 0 0 0 131 0 8 2 5 0 8 2 2 2 2 234 11 17 17 17 17 
3 0 0 0 131 0 7 1 6 0 0 0 0 0 0 81 4 17 20 17 17 
3 0 0 0 131 0 4 17 3 0 0 0 0 0 86 88 4 17 17 17 17 
3 0 0 0 131 0 4 17 3 0 0 0 0 0 92 92 4 17 17 20 17 
9 6 7 28 37 155 12 17 9 1 1 1 1 1 233 233 12 17 17 17 17 
10 5 8 38 2 2 38 2 2 38 2 2 38 2 2 2 2 2 11 17 17 
9 1 6 131 0 0 131 0 0 131 0 0 131 0 0 0 7 1 12 17 18 
10 2 5 131 0 0 131 0 0 131 0 0 131 0 7 6 8 2 11 17 17 
3 0 0 131 0 0 131 0 0 131 0 0 131 0 4 33 116 116 34 17 20 
3 0 0 131 0 0 131 0 0 131 0 0 131 0 4 3 0 0 4 17 18 
9 1 1 37 1 1 37 1 1 37 1 1 37 1 12 9 6 7 12 17 17 
10 2 2 2 2 2 38 2 2 38 2 2 38 2 38 2 5 8 11 17 17 
3 0 0 0 0 0 131 0 0 131 0 0 131 0 131 0 0 0 4 17 17 
3 0 0 0 0 0 131 0 0 131 0 0 131 0 131 0 0 0 4 17 17 
3 0 0 0 0 0 131 0 0 131 0 0 131 0 131 0 0 0 4 17 20 
9 6 7 28 1 1 37 26 1 37 1 1 37 1 37 1 1 1 12 17 18 
10 5 8 2 238 2 2 38 11 18 10 38 2 2 2 2 2 2 11 17 17 
3 0 0 0 0 0 0 131 8 2 5 131 0 0 0 0 0 0 4 17 17 
3 0 0 0 0 0 0 131 7 1 6 131 0 0 0 0 0 0 4 17 17 
9 1 1 1 237 1 1 37 12 18 9 37 1 1 16 13 6 7 12 17 17 
10 2 2 2 38 2 2 238 2 238 2 238 2 2 2 2 5 8 11 17 17 
235 133 134 0 131 0 0 0 0 0 0 0 0 0 0 0 0 0 4 17 17 
235 135 136 0 131 0 0 0 0 0 0 0 0 0 0 0 0 0 4 17 17 
3 0 0 0 131 0 0 0 0 0 0 0 0 0 0 0 0 0 4 17 17 
9 221 222 1 37 6 0 0 0 0 0 0 0 0 0 0 0 0 240 17 17 
17 17 17 17 17 33 116 116 116 116 116 116 116 116 116 116 116 116 34 17 17 
10 2 2 2 2 5 0 0 86 82 82 132 82 82 85 0 0 0 4 17 17 
3 0 0 0 0 0 0 0 87 93 96 0 0 0 94 0 0 0 204 17 17 
3 0 15 237 1 1 237 1 6 0 7 1 201 201 233 237 14 0 204 18 17 
9 16 17 17 18 17 17 10 5 0 8 2 11 17 17 17 17 13 12 17 17 
10 2 2 2 2 2 11 3 0 0 0 0 4 10 2 2 2 2 11 17 17 
3 0 0 0 0 0 4 3 0 0 0 0 4 3 0 0 0 0 4 17 17 
3 0 0 7 6 0 4 3 0 0 0 0 4 3 0 0 0 0 4 17 17 
3 0 0 4 3 0 4 3 0 0 0 0 4 3 0 0 0 0 4 17 17 
3 0 0 4 3 0 4 33 116 116 116 116 34 3 0 150 0 0 4 17 17 
3 0 0 4 3 0 4 3 0 0 0 0 240 3 0 81 0 0 4 17 17 
3 0 0 4 3 0 4 3 0 0 0 0 4 3 0 81 0 0 4 17 17 
3 0 0 4 3 0 4 239 0 0 0 0 4 3 0 81 0 0 4 17 17 
3 0 0 4 3 0 4 3 0 0 0 0 4 3 0 81 0 0 4 17 17 
3 0 0 4 3 0 4 3 0 0 0 0 240 3 0 81 0 0 4 17 17 
3 0 0 4 3 0 4 3 0 0 0 0 4 3 0 81 0 0 4 17 17 
3 0 0 4 3 0 4 239 0 0 0 0 4 3 0 81 0 0 4 17 17 
3 0 0 4 3 0 4 3 0 0 0 0 4 3 0 81 0 0 4 17 17 
3 0 0 4 3 0 4 3 0 0 0 0 240 3 0 81 0 0 4 17 17 
3 0 0 4 3 0 4 33 116 116 116 116 34 3 0 81 0 0 4 17 17 
3 0 0 4 3 0 4 3 0 0 0 0 4 3 0 81 0 0 4 17 17 
3 0 0 4 3 0 4 3 0 0 0 0 4 3 0 81 0 0 4 17 17 
3 0 0 4 3 0 4 33 116 116 116 116 34 3 0 81 0 0 4 17 17 
3 0 0 4 3 0 4 3 0 0 0 0 4 3 0 81 0 0 4 17 17 
3 0 0 4 3 0 4 3 0 0 0 0 4 3 0 81 0 0 4 17 17 
3 0 0 4 3 0 4 3 0 0 0 0 4 3 0 81 0 0 4 17 17 
3 0 0 4 3 0 4 3 0 0 0 0 4 3 0 81 0 0 4 17 17 
3 0 0 4 3 0 4 33 116 116 116 116 34 3 0 81 0 0 4 17 17 
3 0 0 4 3 0 4 3 0 0 0 0 4 3 0 81 0 0 4 17 18 
3 0 0 4 3 0 4 3 0 0 0 0 4 3 0 81 0 0 4 17 17 
3 0 0 4 3 0 4 3 0 0 0 0 4 3 0 81 0 0 4 17 17 
3 0 0 4 3 0 4 3 0 0 0 0 4 3 0 81 0 0 4 17 17 
3 0 0 4 3 0 4 3 0 0 0 0 4 3 0 92 0 0 4 17 18 
3 0 0 4 3 0 4 3 0 0 0 0 4 3 0 81 0 0 4 17 17 
3 0 0 4 3 0 4 3 0 0 0 0 4 3 0 81 0 0 4 17 17 
3 0 0 4 3 0 4 3 0 0 0 0 4 3 0 81 0 0 4 17 17 
3 0 0 4 3 0 4 3 0 0 0 0 4 3 0 81 0 0 4 17 17 
3 0 0 4 3 0 4 3 0 0 0 0 4 3 0 81 0 0 4 17 17 
3 0 0 4 3 0 4 3 0 0 0 0 4 3 0 81 0 0 4 17 17 
3 0 0 4 3 0 4 3 0 0 0 0 4 3 0 92 0 0 4 17 17 
3 0 0 4 3 0 4 3 0 0 0 0 4 3 0 81 0 0 4 17 17 
3 0 0 4 3 0 4 33 116 116 116 116 34 3 0 81 0 0 4 17 17 
3 0 0 4 3 0 4 3 0 0 0 0 4 3 0 81 0 0 4 17 17 
3 0 0 4 3 0 4 3 0 0 0 0 4 3 0 81 0 0 4 17 17 
3 0 0 4 3 0 8 5 0 0 0 0 4 3 0 81 0 0 4 17 17 
3 0 0 4 3 0 0 0 0 0 0 0 4 3 0 81 0 0 4 17 17 
3 0 0 4 9 1 1 1 1 1 1 1 12 3 0 92 0 0 4 17 17 
3 0 0 8 2 2 38 2 2 2 2 2 2 5 0 81 0 0 4 17 17 
3 0 99 95 93 85 131 0 0 0 0 0 0 0 0 81 0 0 4 17 17 
3 0 92 0 86 83 131 0 0 0 0 0 0 0 0 81 0 0 4 17 17 
43 0 92 0 94 81 131 0 223 113 0 0 0 0 0 92 0 0 44 57 57 
61 41 213 41 213 213 37 41 224 213 41 41 41 41 41 213 46 47 62 57 57 
50 42 42 42 42 42 42 42 42 42 42 42 42 42 42 42 45 48 51 57 57 
43 0 0 0 0 0 0 0 0 0 0 0 0 0 0 0 0 0 44 57 57 
43 0 0 0 0 0 0 0 0 0 0 0 0 0 0 0 0 0 44 57 57 
43 0 0 0 0 0 0 0 0 0 0 0 0 0 0 0 0 111 44 57 63 
49 41 41 41 41 41 41 41 41 41 41 41 41 41 41 41 41 213 52 57 57 
3
1 96 2
3 96 2
5 96 2
0
