24 18
0 0 0 0 0 0 0 0 0 0 0 0 0 0 0 0 0 0 0 0 0 0 0 0 
0 0 0 0 0 0 0 0 0 0 0 0 0 0 0 0 0 0 0 0 0 0 0 0 
0 0 0 0 0 0 0 0 0 0 0 0 0 0 0 0 0 0 0 0 0 0 0 0 
1 6 7 1 1 1 1 1 1 1 1 1 1 1 1 1 1 1 1 1 1 1 1 1 
10 5 4 17 17 17 17 17 10 2 2 2 2 2 2 11 10 2 2 2 2 2 2 2 
3 0 8 2 2 2 11 10 5 0 7 6 0 7 6 4 9 1 1 1 1 1 6 0 
9 1 1 1 1 6 4 3 7 6 4 3 0 4 3 4 10 238 2 2 11 10 5 0 
10 2 2 2 2 5 4 3 4 3 4 3 0 4 3 8 5 0 0 0 8 5 0 0 
3 0 0 1 1 1 12 3 4 3 4 3 0 4 3 7 6 0 0 0 7 6 0 7 
3 0 0 2 2 2 2 5 4 3 4 3 0 4 3 4 3 0 7 1 12 3 0 8 
9 1 1 1 1 1 1 1 12 3 4 3 0 4 3 4 3 0 4 10 2 5 0 0 
10 2 2 2 2 2 2 2 2 5 4 3 0 4 3 4 3 0 4 3 0 0 0 0 
3 0 7 1 1 1 1 1 1 1 12 3 0 4 3 4 3 0 4 3 0 0 111 0 
0 0 8 2 2 2 2 2 2 2 2 5 0 4 3 4 3 0 4 235 93 82 84 0 
1 1 1 1 1 6 0 7 1 1 1 1 1 12 3 4 3 0 4 235 133 134 0 0 
198 198 198 198 198 5 0 4 10 2 2 2 2 2 5 4 3 0 4 235 135 136 0 0 
0 0 0 0 0 0 0 4 3 0 0 0 0 0 0 4 3 0 4 3 0 0 0 0 
197 197 197 197 197 197 197 12 9 1 1 1 1 1 1 12 9 237 12 9 1 1 1 1 
0
0
