20 16
0 0 0 0 0 0 0 0 0 0 0 0 0 0 0 0 0 0 0 0 
0 0 0 0 0 0 0 0 0 0 0 0 0 0 0 0 0 0 0 0 
0 0 0 0 0 0 0 0 0 0 0 0 0 0 0 0 0 0 0 0 
1 1 1 1 1 1 1 1 1 1 1 1 1 1 6 7 1 1 1 1 
10 2 2 2 2 2 2 2 2 2 2 234 234 2 5 8 2 2 2 11 
3 0 0 0 0 0 0 0 0 0 0 81 81 0 0 0 0 0 0 4 
3 0 0 0 0 0 0 0 0 0 0 81 81 0 0 0 0 0 0 4 
3 0 0 111 0 0 0 0 0 0 0 81 81 0 0 0 0 0 0 4 
3 0 0 81 0 0 0 0 0 0 0 81 81 0 0 0 0 0 0 4 
3 0 0 81 0 0 0 0 0 0 0 81 81 0 0 0 0 0 0 4 
3 0 0 94 0 0 0 0 0 0 0 81 81 0 0 0 0 0 0 4 
3 0 0 100 93 93 93 82 93 95 93 91 84 0 0 0 0 0 0 4 
3 0 0 0 0 0 0 0 0 0 0 0 0 0 0 0 0 0 0 4 
3 0 0 0 0 0 0 0 0 0 0 0 0 0 0 0 0 0 0 4 
9 1 1 1 1 1 1 1 1 1 1 1 1 1 1 1 1 1 1 12 
17 17 17 17 17 17 17 17 17 17 17 17 17 17 17 17 17 17 17 17 
5
1 22 0
14 22 0
8 22 1
5 22 2
12 22 2
0
