30 25
0 0 0 0 0 0 0 0 0 0 0 0 0 0 0 0 0 0 0 0 0 0 0 0 0 0 0 0 0 0 
0 0 0 0 0 0 0 0 0 0 0 0 0 0 0 0 0 0 0 0 0 0 0 0 0 0 0 0 0 0 
0 0 0 0 0 0 0 0 0 0 0 0 0 0 0 0 0 0 0 0 0 0 0 0 0 0 0 0 0 0 
0 0 0 0 0 0 0 0 0 0 0 0 0 0 0 0 0 0 0 0 0 0 0 0 0 0 0 0 0 0 
0 0 0 0 0 0 0 0 0 0 0 0 0 0 0 0 0 0 0 0 0 0 0 0 0 0 0 0 0 0 
0 0 0 0 0 0 0 0 0 0 0 0 0 0 0 0 0 0 0 0 0 0 0 0 0 0 0 0 0 0 
41 41 41 41 41 41 41 41 41 41 41 46 47 41 41 41 41 41 41 41 41 41 41 41 41 41 41 41 41 41 
50 42 42 42 42 42 42 42 42 42 218 45 48 218 42 42 42 42 42 42 42 42 42 42 42 42 42 42 42 51 
43 0 47 46 0 0 0 0 0 0 0 0 0 0 0 0 0 0 0 0 0 0 0 0 0 0 0 0 0 44 
43 0 44 219 0 0 0 0 0 0 0 0 0 0 0 0 0 0 0 0 0 0 0 0 0 0 0 0 0 220 
43 0 44 49 41 41 41 41 41 41 217 217 217 217 41 41 41 41 41 41 41 41 41 41 41 41 41 41 41 52 
33 116 34 57 57 57 57 57 57 57 57 57 57 57 57 57 57 57 57 57 57 57 57 57 57 57 57 57 57 57 
43 0 48 42 42 42 42 42 198 198 198 198 42 42 42 38 218 218 218 42 42 42 42 42 218 218 218 218 218 51 
43 0 0 0 0 0 0 0 0 0 0 0 0 0 0 131 0 0 0 0 0 0 0 0 0 0 0 0 0 220 
43 0 0 0 0 0 0 0 0 0 0 0 0 0 0 131 0 0 0 0 0 0 0 0 0 0 0 0 0 220 
43 0 0 0 0 0 0 0 0 0 0 0 0 0 0 131 0 0 0 0 0 0 0 0 0 0 0 0 0 44 
43 0 0 0 0 0 0 0 0 0 0 0 0 0 0 131 0 0 0 0 0 0 0 0 0 0 0 133 134 216 
43 0 0 0 0 0 0 0 0 0 0 0 0 0 0 131 0 0 0 0 0 0 0 0 0 0 0 135 136 216 
219 0 0 0 0 0 0 0 0 0 0 0 0 47 41 37 41 217 41 46 0 0 0 0 0 0 0 0 0 220 
219 0 0 0 0 0 0 0 0 0 0 0 0 220 57 57 57 57 57 215 82 82 82 82 82 82 82 93 93 216 
219 0 0 0 0 0 0 0 0 0 0 0 0 220 57 57 57 57 50 45 0 0 0 0 0 0 0 0 0 220 
219 0 0 0 0 0 0 0 0 0 0 0 0 220 57 57 57 57 219 0 0 0 0 0 0 0 0 0 0 220 
219 0 0 0 0 0 0 0 0 0 0 0 0 44 57 57 57 57 219 0 0 0 0 0 0 111 0 0 0 220 
43 0 0 0 0 0 0 0 0 0 0 0 0 48 42 42 42 42 45 0 0 0 0 86 95 97 0 0 0 220 
49 41 217 217 217 217 41 41 197 197 197 197 41 41 41 41 41 41 41 41 41 41 41 213 41 41 217 217 217 62 
2
9 31 1
5 31 1
0
